11 12
##### # ###
#   # #   #
# #   ### #
# ####### #
# #     # #
# # # # # #
# # # # # #
# # # # # #
# # # # # #
# # # # # #
#   # #   #
###########
